|=================================================================================================|
|                                                                                                 |
|                                                                                                 |
|                                                                                                 |
|                                                                                                 |
|                      |==================================================|                       |
|                      |=====           |     ======     |           =====|                       |
|                      |=====           |     ======     |           =====|                       |
|                      |=====           |       áV       |           =====|                       |
|                      |              ==|================|==              |                       |
|                      |           ===|         Åú         |===           |                       |
|                      |        ===|                          |===        |                       |
|                      |     ===|                                |===     |                       |
|                      |  ===|                                      |===  |                       |
|                      |==|                                            |==|                       |
|                      |                                                  |                       |
|                      |                                                  |                       |
|                      |   ===     ===                       ===     ===  |                       |
|                      |    |       |                         |       |   |                       |
|                      |==================================================|                       |
|                                                                                                 |
|                                                                                                 |
|                                                                                                 |
|                                                                                                 |
|=================================================================================================|